1113be_map
.E 0
.B 291
p
// left
-5 -1 -5 -5 -1 -5 -5 -1 +5 -5 -1 +5 
// right
+5 -1 -5 +5 -1 -5 +5 -1 +5 +5 -1 +5 
// forward
+5 -1 +5 +5 -1 +5 -5 -1 +5 -5 -1 +5 
// back
+5 -1 -5 +5 -1 -5 -5 -1 -5 -5 -1 -5 
// top
-5 -1 -5 +5 -1 -5 +5 -1 +5 +5 -1 -5 
// bottom (identical)
-5 -1 -5 +5 -1 -5 +5 -1 +5 +5 -1 -5 
e
